20,20
1,1,1,1,1,1,1,1,1,1,1,1,1,1,1,1,1,1,1,1
1,1,1,1,1,1,1,1,1,1,1,1,1,1,1,1,1,1,1,1
1,1,1,1,0,4,0,4,0,4,0,0,1,1,1,1,1,1,1,1
1,1,1,1,0,0,0,0,4,0,0,0,1,1,1,1,1,1,1,1
1,1,1,1,0,0,1,1,1,1,0,0,1,1,1,1,1,1,1,1
1,1,1,1,0,0,1,1,1,1,0,0,1,1,1,1,1,1,1,1
1,1,1,1,0,0,1,1,1,1,0,0,1,1,1,1,1,1,1,1
1,1,1,1,1,0,0,0,0,0,0,1,1,1,1,1,1,1,1,1
1,1,1,1,1,0,5,0,0,5,0,1,1,1,1,1,1,1,1,1
1,1,1,1,1,1,1,0,0,1,1,1,1,1,1,1,1,1,1,1
1,1,1,1,1,1,1,0,0,1,1,1,1,1,1,1,1,1,1,1
1,1,1,1,1,0,0,0,0,0,0,1,1,1,1,1,1,1,1,1
1,1,1,1,1,0,5,0,0,5,0,1,1,1,1,1,1,1,1,1
1,1,1,1,1,1,1,1,1,1,0,1,1,1,1,1,1,1,1,1
1,1,1,1,1,1,1,0,5,1,0,1,1,1,1,1,1,1,1,1
1,1,1,1,1,1,1,5,6,0,0,1,1,1,1,1,1,1,1,1
1,1,1,1,1,1,1,0,5,0,1,1,1,1,1,1,1,1,1,1
1,1,1,1,1,1,1,1,1,1,1,1,1,1,1,1,1,1,1,1
1,1,1,1,1,1,1,1,1,1,1,1,1,1,1,1,1,1,1,1
1,1,1,1,1,1,1,1,1,1,1,1,1,1,1,1,1,1,1,1